ElepDN	Pecos
ElepDP	Pecos
ElepDL	Pecos
ElepDM	Pecos
ElepDO	Pecos
ElepDA	Llano
ElepDB	Llano
ElepDC	Llano
ElepCX	Llano
ElepCZ	Llano
ElepBL	Concho
ElepBO	Concho
ElepBQ	Concho
ElepBM	Concho
ElepBR	Concho
ElepBZ	SanSaba
ElepCB	SanSaba
ElepCE	SanSaba
ElepCC	SanSaba
ElepCD	SanSaba
ElepG	Guadalupe
ElepJ	Guadalupe
ElepR	Guadalupe
ElepY	Guadalupe
ElepQ	Guadalupe
ElepCN	Pedernales
ElepCP	Pedernales
ElepCQ	Pedernales
ElepCV	Pedernales
ElepCO	Pedernales
ElepAY	Nueces
ElepDZ	Nueces
ElepEB	Nueces
ElepBA	Nueces
ElepBB	Nueces
ElepA	FrioSanAntonio
ElepAL	FrioSanAntonio
ElepAR	FrioSanAntonio
ElepAS	FrioSanAntonio
ElepAN	FrioSanAntonio
ElepAP	FrioSanAntonio
ElepAA	FrioSanAntonio
ElepAD	FrioSanAntonio
ElepAE	FrioSanAntonio
ElepAF	FrioSanAntonio
ElepZ	FrioSanAntonio