ElepDN	ConchoSanSabaPecos
ElepDP	ConchoSanSabaPecos
ElepDL	ConchoSanSabaPecos
ElepDM	ConchoSanSabaPecos
ElepDO	ConchoSanSabaPecos
ElepDA	LlanoGuadalupePedernalesNuecesFrioSanAntonio
ElepDB	LlanoGuadalupePedernalesNuecesFrioSanAntonio
ElepDC	LlanoGuadalupePedernalesNuecesFrioSanAntonio
ElepCX	LlanoGuadalupePedernalesNuecesFrioSanAntonio
ElepCZ	LlanoGuadalupePedernalesNuecesFrioSanAntonio
ElepBL	ConchoSanSabaPecos
ElepBO	ConchoSanSabaPecos
ElepBQ	ConchoSanSabaPecos
ElepBM	ConchoSanSabaPecos
ElepBR	ConchoSanSabaPecos
ElepBZ	ConchoSanSabaPecos
ElepCB	ConchoSanSabaPecos
ElepCE	ConchoSanSabaPecos
ElepCC	ConchoSanSabaPecos
ElepCD	ConchoSanSabaPecos
ElepG	LlanoGuadalupePedernalesNuecesFrioSanAntonio
ElepJ	LlanoGuadalupePedernalesNuecesFrioSanAntonio
ElepR	LlanoGuadalupePedernalesNuecesFrioSanAntonio
ElepY	LlanoGuadalupePedernalesNuecesFrioSanAntonio
ElepQ	LlanoGuadalupePedernalesNuecesFrioSanAntonio
ElepCN	LlanoGuadalupePedernalesNuecesFrioSanAntonio
ElepCP	LlanoGuadalupePedernalesNuecesFrioSanAntonio
ElepCQ	LlanoGuadalupePedernalesNuecesFrioSanAntonio
ElepCV	LlanoGuadalupePedernalesNuecesFrioSanAntonio
ElepCO	LlanoGuadalupePedernalesNuecesFrioSanAntonio
ElepAY	LlanoGuadalupePedernalesNuecesFrioSanAntonio
ElepDZ	LlanoGuadalupePedernalesNuecesFrioSanAntonio
ElepEB	LlanoGuadalupePedernalesNuecesFrioSanAntonio
ElepBA	LlanoGuadalupePedernalesNuecesFrioSanAntonio
ElepBB	LlanoGuadalupePedernalesNuecesFrioSanAntonio
ElepA	LlanoGuadalupePedernalesNuecesFrioSanAntonio
ElepAL	LlanoGuadalupePedernalesNuecesFrioSanAntonio
ElepAR	LlanoGuadalupePedernalesNuecesFrioSanAntonio
ElepAS	LlanoGuadalupePedernalesNuecesFrioSanAntonio
ElepAN	LlanoGuadalupePedernalesNuecesFrioSanAntonio
ElepAP	LlanoGuadalupePedernalesNuecesFrioSanAntonio
ElepAA	LlanoGuadalupePedernalesNuecesFrioSanAntonio
ElepAD	LlanoGuadalupePedernalesNuecesFrioSanAntonio
ElepAE	LlanoGuadalupePedernalesNuecesFrioSanAntonio
ElepAF	LlanoGuadalupePedernalesNuecesFrioSanAntonio
ElepZ	LlanoGuadalupePedernalesNuecesFrioSanAntonio